F   23,30,35

NO    ./Textures/moon3.xpm
C     20,44,54
SO    ./Textures/moon2.xpm
EA  ./Textures/moon4.xpm
WE ./Textures/moon1.xpm
                                1111
                                1001
11111111111111111111111111111111111111111
1111000000000110000000000001 1
 1010110000011100000100000111111111111
111111111110010000000000001100000011111111
1111111110110000011100000100000011
100000000011110001110111111111111
11110111111001011100000010001
11110111111111011101010010001
1100000011010101110000010001
10000000000000W01100000010001
10000000000000001101010010001
1100000111010101111101111010111
11110111 1110101 10111101001
11111111 1111111 1111111111
111111111111


111111111111
111111111111
111111111111
11111W111111
111111111111
111111111111