F   12,5,100
C   71,46,50

NO    ./Textures/night1.xpm
SO    ./Textures/night4.xpm 
EA  ./Textures/night2.xpm 
WE ./Textures/night3.xpm

        1111111111111111111111111
        1000000000110000000000001
        1011000001110000010000001
        1001000000000000110000001
111111111011000001110000010000001
100000000S11000001110111111111111
11110111111111011100000010001
11110111111111011101010010001
1100000011010101110000010001
10000000000000001100000010001
10000000000000001101010010001
1100000111010101111101111010111
11110111 1110101 10111101001
11111111 1111111 1111111111